

NO Tools/textures/simonkraft/respawn_anchor_side0.xpm
EA Tools/textures/simonkraft/respawn_anchor_side2.xpm
SO Tools/textures/simonkraft/respawn_anchor_side4.xpm
WE Tools/textures/simonkraft/respawn_anchor_side3.xpm




F 52,254,0000000
C 35,19,73






1111111111111111111111111
1000000000000000000000001
1000100000001000000010001
1000000000011100000000001
1000000000111110000000001
1000000000011100000000001
100010S000001000000010001
1000000000000000000000001
1111111111111111111111111
